################
#...#..........#
#...#..........#
#...#..........#
#......######..#
#........#.....#
################