################
#...#..~~~~~~..#
#...#..~~~~~~..#
#...#..~~~~~~..#
#......######..#
#........#.....#
################