#########################################
#...#..~~~~~~............................
#...#..~~~~~~............................
#...#..~~~~~~............................
#......######............................
#........#...............................
#########################################